#domain
hospital
#levelname
MAsimple1
#colors
red: 0, A, B
green: 1, C
#initial
++++++++++++++++++++++++++++
+     0                A   +
+     1                    +
+B+++++++++++++++++        +
+      C          +        +
++++++++++++++++++++++++++++
#goal
++++++++++++++++++++++++++++
+AB                        +
+                          +
+ +++++++++++++++++   C    +
+                 +        +
++++++++++++++++++++++++++++
#end
