#domain
hospital
#levelname
MAthomasAppartment
#colors
red: 0, A, B, C
blue: 1, D, E, F, G
cyan: 2, H, I, J, K, L
purple: 3, M, N, O
#initial
                   +++++++++
                   +D      +
++++++++++++++++++++       +
+   C  +     +     +   E   +
+ A    +     +     +       +
+      +     +   3 +F   1  +
+   B  +     +     +       +
+                  +      G+
+++++++++O+ +++++++++  +++ +
+        N+          KL +  +
+        M+     I       +  +
+                   0   +  +
+   2        J          +  +
+         +             +  +
+         +      H      +  +
+         +             +  +
++++++++++++++++++++++++++++
#goal
                   +++++++++
                   +  1DEFG+
++++++++++++++++++++       +
+      +     +MNO3 +       +
+      +     +     +       +
+      +     +     +       +
+      +     +     +       +
+                  +       +
+++++++++ + +++++++++  +++ +
+         +             +  +
+         +             +  +
+                       +  +
+                       +  +
+         +             +C +
+2        +             +B +
+HIJKL    +             +A0+
++++++++++++++++++++++++++++
#end
