#domain
hospital
#levelname
MAthomasAppartment
#colors
red: 0, A, B, C
blue: 1, D, E, F, G
cyan: 2, H, I, J, K, L
purple: 3, M, N, O
#initial
                   +++++++++
                   +       +
++++++++++++++++++++ +++++++
+ABC   +    ++GFED + +++++++
++++++ ++++ ++++++ + +++++++
++++++ ++++ ++++++3+      1+
++++++ ++++ ++++++ ++++++  +
+                  +       +
+++++++++O+ +++++++++ ++++ +
+++++++++N+ ++++0       +  +
+++++++++M+ ++++I +++++++ ++
+   2             +++++++ ++
+ +++++++++ ++++ J+++++++ ++
+ +++++++++ ++++K ++++++++++
+ +++++++++ ++++ H++++++++++
+     +++++ ++++L ++++++++++
++++++++++++++++++++++++++++

#goal
                   +++++++++
                   +   DEFG+
++++++++++++++++++++ +++++++
+      +MNO ++     + +++++++
++++++ ++++ ++++++ + +++++++
++++++ ++++ ++++++ +       +
++++++ ++++ ++++++ ++++++  +
+                  +       +
+++++++++ + +++++++++ ++++ +
+++++++++ + ++++        +  +
+++++++++ + ++++  +++++++C++
+                 +++++++B++
+ +++++++++ ++++  +++++++A++
+ +++++++++ ++++  ++++++++++
+ +++++++++ ++++  ++++++++++
+HIJKL+++++ ++++  ++++++++++
++++++++++++++++++++++++++++

#end
