#domain
hospital
#levelname
MAthomasAppartment
#colors
red: 0, A, B, C
blue: 1, D, E, F, G
cyan: 2, H, I, J, K, L
purple: 3, M, N, O
#initial
                   +++++++++
        ++++       +       +
+++++++++  +++++++++ +++++++
+CBA   +    ++DEFG + +++++++
++++++ ++++ ++++++ + +++++++
++++++ ++++ ++++++3+      1+
++++++ ++++ ++++++ ++++++  +
+                  +       +
+++++++++M+ +++++++++ ++++ +
+++++++++N+ ++++0       +  +
+++++++++O+ ++++L +++++++ ++
+   2             +++++++ ++
+ +++++++++ ++++ K+++++++ ++
+ +++++++++ ++++J ++++++++++
+ +++++++++ ++++ I++++++++++
+     +++++ ++++H ++++++++++
++++++++++++++++++++++++++++

#goal
                   +++++++++
        ++++       +   DEFG+
+++++++++  +++++++++ +++++++
+      +MNO ++     + +++++++
++++++ ++++ ++++++ + +++++++
++++++ ++++ ++++++ +       +
++++++ ++++ ++++++ ++++++  +
+                  +       +
+++++++++ + +++++++++ ++++ +
+++++++++ + ++++        +  +
+++++++++ + ++++  +++++++C++
+                 +++++++B++
+ +++++++++ ++++  +++++++A++
+ +++++++++ ++++  ++++++++++
+ +++++++++ ++++  ++++++++++
+HIJKL+++++ ++++  ++++++++++
++++++++++++++++++++++++++++

#end
