#domain
hospital
#levelname
MAthomasAppartment
#colors
red: 0, A, B, C
blue: 1, D, E, F, G
cyan: 2, H, I, J, K, L
purple: 3, M, N, O
#initial
                   +++++++++
         +++       +       +
++++++++++ +++++++++ +++++++
+CBA   +    ++DEFG + +++++++
++++++ ++++ ++++++ + +++++++
++++++ ++++ ++++++3+      1+
++++++ ++++ ++++++ ++++++  +
+                  +       +
+++++++++M+ +++++++++ ++++ +
+++++++++N+ ++++0       +  +
+++++++++O+ ++++H +++++++ ++
+   2             +++++++ ++
+ +++++++++ ++++I +++++++ ++
+ +++++++++ ++++ J++++++++++
+ +++++++++ ++++K ++++++++++
+     +++++ ++++ L++++++++++
++++++++++++++++++++++++++++

#goal
                   +++++++++
         +++       +   DEFG+
++++++++++ +++++++++ +++++++
+      +MNO ++     + +++++++
++++++ ++++ ++++++ + +++++++
++++++ ++++ ++++++ +       +
++++++ ++++ ++++++ ++++++  +
+                  +       +
+++++++++ + +++++++++ ++++ +
+++++++++ + ++++        +  +
+++++++++ + ++++  +++++++C++
+                 +++++++B++
+ +++++++++ ++++  +++++++A++
+ +++++++++ ++++  ++++++++++
+ +++++++++ ++++  ++++++++++
+HIJKL+++++ ++++  ++++++++++
++++++++++++++++++++++++++++

#end
