#domain
hospital
#levelname
AAAFUN
#colors
blue: 1,A
lightblue: 0,B
green: 2,3,F,N,U
purple: 4,5,G
red:6,P,S,T,R
orange: 7,8,9,M
cyan: Z
#initial
+++++++++++++++++++++++++++++++++
+++ ++ ++ +++ +                 + 
+2F  U    N3+ + +++++++ + +++++ +  
++++++ ++++++ +         +   + + +  
+++     1++++ +++++++ +++++ + + +
+++ Z++++++++ + + +   + + +   + +  
+++ Z    A ++++++ + + + + +++ + +
+ B    Z +++++ +    + +     +   +
+++++++Z +++++ ++ +++++++++ + +++
+++0     +++++ ++ +             +  
+5G        4++ +  + + + + + +   +  
+ZZZZZ ZZZZZ++ +  + + + + +++ + +
+      ZZ      ++ + +   +     + + 
+ZZZZZ ZZPZZZZZZ+ + + +++ +++++ + 
+ZZ9ZZ TS 6     + + +     + + + +
+ZZ8ZZ  RR ZZZZZ+ + +++++++ + + + 
+ZZ7ZZ     ZZZZZ+               +
+++ +++++++++++++++++++++++++++ +
+ + + +++ +++ + +++ + + +++++ + +
+     +         +           +   +
+ +++ + ++++++ ++++ +++++ +++++ +
+  M+                       +   +
+ +++ +++ +++ + +++++ +++++ + + +
+ +     +     +     +     +   + +
+ + +++ +++ +++++ +++++++ +++++ +
+ +   +   +     +     +   +     +
+ +++ +++ + + +++++ +++ +++++++ +
+ +     + + + +   +   +       + +
+ + +++ + + + +   +++ +++++++ + +
+         + + +     + +     +   +
+++++ +++ + + +++++ + +++++ +++ +
+         +   +       +         +
+ +++++++++++ + +++ +++++ +++++ +
+ + +       +       +     +     +
+ + + +++ +++++++++++ +++++++++ +
+ + + + + +   +                 +
+ + + + +++ + + +++++++ + +++++ +
+ +   +     + +         +   + + +
+ + +++ +++++ +++++++ +++++ + + +
+       + + + + + +   + + +   + +
+ +++++++ + + + + + + + + +++ + +
+ +                 + +     +   +
+ + +++++++ + + + +++++++++ + +++
+           + + + +             +
+++++++++++++++++++++++++++++++++
#goal
+++++++++++++++++++++++++++++++++
+++F++U++N+++ +7                + 
+3         2+ + +++++++ + +++++ + 
++++++ ++++++ +         +   + + + 
+++     0++++ +++++++ +++++ + + +
+++  ++++++++ + + +   + + +   + +
+++       A++++++ + + + + +++ + +
+B       +++++P+    + +     +   +
+++++++  +++++S++ +++++++++ + +++
+++1     +++++T++ +             +
+4         5++ +  + + + + + +   +  
+           ++ +  + + + + +++ + +
+G             ++ + +   +     + + 
+               + + + +++ +++++ +  
+            6RR+ + +     + + + +
+               + + +++++++ + + +  
+               +               +
+++ +++++++++++++++++++++++++++ +
+ + + +++ +++ + +++ + + +++++ + +
+     +         +           +   +
+ +++ + ++++++ ++++ +++++ +++++ +
+   +                       +   +
+ +++ +++ +++ + +++++ +++++ + + +
+ +     +     +     +     +   + +
+ + +++ +++ +++++ +++++++ +++++ +
+ +   +   +     +     +   +     +
+ +++ +++ + + +++++ +++ +++++++ +
+ +     + + + +   +   +       + +
+ + +++ + + + + 9 +++ +++++++ + +
+M        + + +     + +     +   +
+++++ +++ + + +++++ + +++++ +++ +
+         +   +       +         +
+ +++++++++++ + +++ +++++ +++++ +
+ + +       +       +     +     +
+ + + +++ +++++++++++ +++++++++ +
+ + + + + +   +                 +
+ + + + +++ + + +++++++ + +++++ +
+ +   +     + +         +   + + +
+ + +++ +++++ +++++++ +++++ + + +
+       + + + + + +   + + +   + +
+ +++++++ + + + + + + + + +++ + +
+ +                 +8+     +   +
+ + +++++++ + + + +++++++++ + +++
+           + + + +             +
+++++++++++++++++++++++++++++++++
#end