#domain
hospital
#levelname
AGACode
#colors
blue: 0, A
red: 1, B
cyan: 2, C
purple: 3, D
green: 4, E
orange: 5, F
#initial
++++++++++++++++++++++++++++++++++++++++++++
+0 ABC            + DEF                 3  +
+++++++++++++++++ ++++++++++++++++++++++++ +
+                 +                        +
+ +++++++++++++++++ ++++++++++++++++++++++++
+       4         +          1             +
+++++++++++++++++ ++++++++++++++++++++++++ +
+                 +                        +
+ +++++++++++++++++ ++++++++++++++++++++++++
+       5         +           2            +
+++++++++++++++++ ++++++++++++++++++++++++ +
+                 +                        +
+ +++++++++++++++++ ++++++++++++++++++++++++
+                 +                        +
+++++++++++++++++ ++++++++++++++++++++++++ +
+                 +                        +
+ +++++++++++++++++ ++++++++++++++++++++++++
+                 +                        +
+++++++++++++++++ ++++++++++++++++++++++++ +
+                 +                        +
+ +++++++++++++++++ ++++++++++++++++++++++++
+                 +                        +
+++++++++++++++++ ++++++++++++++++++++++++ +
+                 +                        +
+ +++++++++++++++++ ++++++++++++++++++++++++
+                 +                        +
+++++++++++++++++ ++++++++++++++++++++++++ +
+                 +                        +
+ +++++++++++++++++ ++++++++++++++++++++++++
+                                          +
++++++++++++++++++++++++++++++++++++++++++ +
+                                          +
+ ++++++++++++++++++++++++++++++++++++++++++
+                                          +
++++++++++++++++++++++++++++++++++++++++++ +
+                                          +
++++++++++++++++++++++++++++++++++++++++++++
#goal
++++++++++++++++++++++++++++++++++++++++++++
+34               +12                      +
+++++++++++++++++ ++++++++++++++++++++++++ +
+                 +                        +
+ +++++++++++++++++ ++++++++++++++++++++++++
+                 +                        +
+++++++++++++++++ ++++++++++++++++++++++++ +
+                 +                        +
+ +++++++++++++++++ ++++++++++++++++++++++++
+                 +                        +
+++++++++++++++++ ++++++++++++++++++++++++ +
+                 +                        +
+ +++++++++++++++++ ++++++++++++++++++++++++
+                 +                        +
+++++++++++++++++ ++++++++++++++++++++++++ +
+                 +                        +
+ +++++++++++++++++ ++++++++++++++++++++++++
+                 +                        +
+++++++++++++++++ ++++++++++++++++++++++++ +
+                 +                        +
+ +++++++++++++++++ ++++++++++++++++++++++++
+                 +                        +
+++++++++++++++++ ++++++++++++++++++++++++ +
+                 +                        +
+ +++++++++++++++++ ++++++++++++++++++++++++
+                 +                        +
+++++++++++++++++ ++++++++++++++++++++++++ +
+                 +                        +
+ +++++++++++++++++ ++++++++++++++++++++++++
+           05                             +
++++++++++++++++++++++++++++++++++++++++++ +
+                                          +
+ ++++++++++++++++++++++++++++++++++++++++++
+                                          +
++++++++++++++++++++++++++++++++++++++++++ +
+  DEF                           ABC       +
++++++++++++++++++++++++++++++++++++++++++++
#end