#domain
hospital
#levelname
aiJoes
#colors
orange: 6,G
green: F
brown: X
grey: Q
pink: 0,A
lightblue: 1,I
blue: 2,J
purple: 3,O
red: 4,E
cyan: 5,D
#initial
++++++++++++++++++++++++++++++
++++++++++++++++++++++ 0   E +
+++++++++++++++++++++++++ ++++
++++++++++++++++++++++       +
++++++++GGGGGG+++++++++++ ++++
+++++++GGGGGGGG+++++++       +
++++++GGGGG  G  +++++++++ ++++
++++++GGGG      ++++++ 1   O +
++++++GG        +++++++++ ++++
++++++GG   ++ + ++++++       +
++++++G    +D D +++++++++ ++++
+++++++         ++++++       +
++++++++  ++++ ++++++++++ ++++
++++XQQX+   65+QX+++++ 2   J +
+++XXXXXX+++++XXXX+++++++ ++++
++XXXX+XXXXXQX+XXXX+++       +
++  +++XXXQQXX++XXXX+++++ ++++
++   ++XQQXXXX++++  ++       +
++   ++QXXXXXX+++   +++++ ++++
+++++++FFFXFFF+++   ++ 3   I +
+++++FFFFF+FFFFF+++++++++ ++++
+++++FFFF+++FFFFF+++++       +
+++     +++++     +++++++ ++++
+       +++++       ++       +
+++++++++++++++++++++++++ ++++
++++++++++++++++++++++ 4   A +
++++++++++++++++++++++++++++++
#goal
++++++++++++++++++++++++++++++
++++++++++++++++++++++A     4+
+++++++++++++++++++++++++ ++++
++++++++++++++++++++++       +
++++++++      +++++++++++ ++++
+++++++        +++++++       +
++++++          +++++++++ ++++
++++++          ++++++I     3+
++++++          +++++++++ ++++
++++++     ++ + ++++++       +
++++++     +    +++++++++ ++++
+++++++         ++++++       +
++++++++  ++++ ++++++++++ ++++
++++    +     +  +++++J     2+
+++      +++++    +++++++ ++++
++    +       +    +++       +
++  +++       ++    +++++ ++++
++   ++       ++++  ++       +
++   ++       +++   +++++ ++++
+++++++       +++   ++O     1+
+++++     +     +++++++++ ++++
+++++    +++     +++++       +
+++     +++++     +++++++ ++++
+       +++++       ++       +
+++++++++++++++++++++++++ ++++
++++++++++++++++++++++E     0+
++++++++++++++++++++++++++++++
#end
