#domain
hospital
#levelname
AIMonkeys
#colors
red: 0, 1, 2, A, B, C
blue: 3, D
orange: 4, E
green: 5, 6
#initial
++++++++++++++++++++++++++++++++
++++++  +  ++++ + + + + + + + ++
++++++  +  ++++ + + + + + + + ++
++ + +  +  ++++ + + + + + + + ++
++                             +
++ + +  +  + ++ + + + + + + + ++
++++++  +  +  + + + + + + + + ++
++++++  +  + ++ + + + + + + + ++
++++++++++++ +++++++++++++++++++
++++++++++++ +++++++++++++++++++
+++++                     ++++++
+++++  0 1 2 3 4 5 6   EE ++++++
+++++                     ++++++
+++++ CBABCDABABCCCAC ++++++++++
+++++ BACDBAACDACDABC ++++++++++
+++++ CBACBADBDADCBAD ++++++++++
+++++ DCBCDABABDCBDBA ++++++++++
++++++++++++++++++++++++++++++++
#goal
++++++++++++++++++++++++++++++++
++++++ D+ D++++A+A+A+A+A+A+A+A++
++++++ D+ D++++B+B+B+B+B+B+B+B++
++4+0+ D+ D++++C+C+C+C+C+C+C+C++
++36                          E+
++5+1+ D+ D+ ++C+C+C+C+C+C+C+C++
++++++ D+ D+ E+B+B+B+B+B+B+B+B++
++++++ D+ D+ ++A+A+A+A+A+A+A+A++
++++++++++++ +++++++++++++++++++
++++++++++++ +++++++++++++++++++
+++++                     ++++++
+++++                     ++++++
+++++                     ++++++
+++++                 ++++++++++
+++++                 ++++++++++
+++++                 ++++++++++
+++++                 ++++++++++
++++++++++++++++++++++++++++++++
#end
