#domain
hospital
#levelname
AltFFour
#colors
blue: 0, 1, A, B, C, D, E, F, G, H,
red: 2, 3, I, J, K, L, M, N, O, P,
green: 4, Q, R, S, T
cyan: 5, U, V, X, Y
#initial
++++++++++++++++++++++++++++++++++++++++++
++++++++++++++++          ++++++++++++++++
++++++++++++++++          ++++++++++++++++
++++++++++++++++          ++++++++++++++++
++++++++++++++++          ++++++++++++++++
++++++++++++++++          ++++++++++++++++
++++++++++++++++          ++++++++++++++++
++++++++++++++++          ++++++++++++++++
++++++++++++++++          ++++++++++++++++
++++++++++++++++          ++++++++++++++++
++++++++++++++++++++ST++++++++++++++++++++
++++++++++++++++++++  ++++++++++++++++++++
++++++++++++++++++++  ++++++++++++++++++++
++++++++++++++++++++  ++++++++++++++++++++
++++++++++++++++++++  ++++++++++++++++++++
+0         +++++          +++++         2+
+          +++++   ABCD   +++++          +
+          +++++   EFGH   +++++          +
+          +++++          +++++          +
+                   4                    +
+                    5                   +
+          +++++          +++++          +
+          +++++   IJKL   +++++          +
+          +++++   MNOP   +++++          +
+1         +++++          +++++         3+
++++++++++++++++++++  ++++++++++++++++++++
++++++++++++++++++++  ++++++++++++++++++++
++++++++++++++++++++  ++++++++++++++++++++
++++++++++++++++++++  ++++++++++++++++++++
++++++++++++++++++++QR++++++++++++++++++++
++++++++++++++++          ++++++++++++++++
++++++++++++++++          ++++++++++++++++
++++++++++++++++          ++++++++++++++++
++++++++++++++++          ++++++++++++++++
++++++++++++++++          ++++++++++++++++
++++++++++++++++          ++++++++++++++++
++++++++++++++++          ++++++++++++++++
++++++++++++++++          ++++++++++++++++
++++++++++++++++          ++++++++++++++++
++++++++++++++++          ++++++++++++++++
++++++++++++++++++++++++++++++++++++++++++
#goal
++++++++++++++++++++++++++++++++++++++++++
++++++++++++++++AB      CD++++++++++++++++
++++++++++++++++EF      GH++++++++++++++++
++++++++++++++++          ++++++++++++++++
++++++++++++++++          ++++++++++++++++
++++++++++++++++          ++++++++++++++++
++++++++++++++++          ++++++++++++++++
++++++++++++++++          ++++++++++++++++
++++++++++++++++          ++++++++++++++++
++++++++++++++++          ++++++++++++++++
++++++++++++++++++++  ++++++++++++++++++++
++++++++++++++++++++  ++++++++++++++++++++
++++++++++++++++++++  ++++++++++++++++++++
++++++++++++++++++++  ++++++++++++++++++++
++++++++++++++++++++  ++++++++++++++++++++
+          +++++          +++++          +
+          +++++          +++++          +
+          +++++          +++++          +
+          +++++          +++++          +
+                                        +
+                                        +
+          +++++          +++++          +
+          +++++          +++++          +
+          +++++          +++++          +
+          +++++          +++++          +
++++++++++++++++++++  ++++++++++++++++++++
++++++++++++++++++++  ++++++++++++++++++++
++++++++++++++++++++  ++++++++++++++++++++
++++++++++++++++++++  ++++++++++++++++++++
++++++++++++++++++++  ++++++++++++++++++++
++++++++++++++++          ++++++++++++++++
++++++++++++++++          ++++++++++++++++
++++++++++++++++          ++++++++++++++++
++++++++++++++++          ++++++++++++++++
++++++++++++++++          ++++++++++++++++
++++++++++++++++          ++++++++++++++++
++++++++++++++++          ++++++++++++++++
++++++++++++++++          ++++++++++++++++
++++++++++++++++IJ      KL++++++++++++++++
++++++++++++++++MN      OP++++++++++++++++
++++++++++++++++++++++++++++++++++++++++++
#end