#domain
hospital
#levelname
Amogus
#colors
blue: 0, B
cyan: 7, A
red: 1, C
green: 2, D
brown: 3, E
grey: 4, F
pink: 5, H
orange: 6, G
#initial
++++++++++++++++++++++++++++++++++++++++++++++++++
+++++++++++++++++++++++        +++++++++++++++++++
++++++++++++++++++++++  BBBCCC  ++++++++++++++++++
+++++++++++++++++++++   AAADDD   +++++   +++++++++
++++++++    ++++++++      01      +++  + +++++++++
+++++++++++              7++2            +++++++++
+++++++++++ +++++ ++     6++3     ++++  ++++++++++
+++ ++++    ++++   +      54      +++++ ++++++++++
+++  +++++ ++  +   ++   GGGEEE   +++      ++   +++
+++   ++++ +   +    ++  HHHFFF  +++   +++       ++
+++            +     ++        +++    +++ ++   +++
+++   ++++ +   +++++++++++ +++++++++++    ++++++++
+++  +++++ ++  +     +++++          ++ +++++++++++
+++ ++++    ++++    ++++++ +++      ++ +++++++++++
+++++++++++ ++++   ++        +      ++ +++++++++++
+++++++++++   ++   ++        +++++++++ +++++++++++
++++++++    + ++ ++++  ++++  ++++++++    +++++++++
+++++++++++++          ++++              +++++++++
+++++++++++++++++++++  ++++  ++++ ++     +++++++++
+++++++++++++++++++++        +     +    ++++++++++
+++++++++++++++++++++        ++   +++  +++++++++++
++++++++++++++++++++++++++++++++++++++++++++++++++
++++++++++++++++++++++++++++++++++++++++++++++++++
#goal
++++++++++++++++++++++++++++++++++++++++++++++++++
+++++++++++++++++++++++        +++++++++++++++++++
++++++++++++++++++++++          ++++++++++++++++++
+++++++++++++++++++++            +++++  G+++++++++
++++++++F   ++++++++      01      +++  + +++++++++
+++++++++++              7++2           G+++++++++
+++++++++++ +++++ ++     6++3     ++++  ++++++++++
+++A++++F   ++++   +      54      +++++ ++++++++++
+++  +++++ ++ C+   ++            +++      ++  E+++
+++   ++++ +   +    ++          +++   +++      E++
+++A          C+    F++        +++G   +++ ++  E+++
+++   ++++ +   +++++++++++ +++++++++++    ++++++++
+++  +++++ ++ C+     +++++          ++ +++++++++++
+++A++++B   ++++    ++++++ +++      ++ +++++++++++
+++++++++++ ++++   ++        +     H++ +++++++++++
+++++++++++   ++  B++        +++++++++ +++++++++++
++++++++B   + ++ ++++  ++++  ++++++++    +++++++++
+++++++++++++          ++++              +++++++++
+++++++++++++++++++++  ++++  ++++ ++    D+++++++++
+++++++++++++++++++++  H     +     +    ++++++++++
+++++++++++++++++++++  H     ++D D+++  +++++++++++
++++++++++++++++++++++++++++++++++++++++++++++++++
++++++++++++++++++++++++++++++++++++++++++++++++++
#end
