#domain
hospital
#levelname
BigDumDum
#colors
red: 0, 1, A, B, C
blue: 2, 3, D, E
#initial
++++++++++++++++++++++++
+C            +       0+
+      +   ++++        +
+      +      +   ++++++
+      +               +
+++  +++      ++++++++++
+                      +
+             +2       +
+++  +++  +++++        +
+             +        +
+             +        +
+             +3       +
+++  +++      +D       +
+             +        +
+     +++++++++        +
+     +   +   +E       +
+     +++++ + +        +
+1         B+          +
+A          +          +
++++++++++++++++++++++++
#goal
++++++++++++++++++++++++
+1           C+A      0+
+2     +   ++++B       +
+      +      +   ++++++
+D     +               +
+++  +++      ++++++++++
+                      +
+             +        +
+++  +++  +++++        +
+             +        +
+             +        +
+             +        +
+++  +++      +        +
+             +        +
+     +++++++++        +
+     +   +   +        +
+     +++++ + +        +
+           +          +
+         E3+          +
++++++++++++++++++++++++
#end