#domain
hospital
#levelname
Binions
#colors
purple: 0
red: 4,5,6,7
orange: 1,2,3,8,A,B,C,G,O,L,D
#initial
+++++++++++++++++++++++
+                     +
+                     +
+     +++++++++++     +
+     +++++ +++++     +
+     +++++ +++++     +
+     +++++ +++++     +
+     +++     +++     +
+     +++++ +++++     +
+     +++++ +++++     +
+     +++++ +++++     +
+     +++++ +++++     +
+                     +
+A   2                +
+                6 7  +
+   3   1         0   +
+                4 5  +
+  B      8           +
+     C         GOLD  +
+++++++++++++++++++++++
#goal
+++++++++++++++++++++++
+                     +
+                     +
+     +++++++++++     +
+     +++++G+++++     +
+     +++++O+++++     +
+     +++++2+++++     +
+     +++L103D+++     +
+     +++++A+++++     +
+     +++++B+++++     +
+     +++++8+++++     +
+     +++++C+++++     +
+                     +
+        4   6        +
+                     +
+        5   7        +
+                     +
+                     +
+                     +
+++++++++++++++++++++++
#end
