#domain
hospital
#levelname
BlahAI
#colors
blue: 0,A
red: 9,W
cyan: 8,X
purple: 7,Z
green: 1
orange: 2,B
pink:3,C
grey:4,D
lightblue:5,6,E
brown:F,G
#initial
+++++++++++++++++++++++++++++++++++++++++++++++++
+    +0+      +                  +      + +     +
+    +1+      +                  +      + +     +
+    + +      +                  +      +2+     +
+    + +      +                  +      + +     +
++++++B++++++++                  ++++++++C+++++++
+7W Z+      4 +                  +        + W  9+
+ WZZ+   W    +                  +   WWWW + ZZZZ+
+   WW   W    +                  + WWW    X     +
+ WWWW   W    +                  +   W     ZZ   +
+   W   XXX   +                  +   W      ZZZZ+
+WWWW     X   +                  +  WWWWWW      +
+XXXW     X   ++++++++++++++++++++  W  W    WXXX+
+CB       X                         W  WWW    AC+
+XXXW     X   ++++++++++++++++++++  W  W    WXXX+
+      XXXX   +                  +  W  W        +
+       W     +                  +  W   W       +
+    WWW      +                  +      WWWWW   +
+   W     WWWW+                  +XXXXX         +
+             +                  +6EEEE         +
+++++++ +++++++                  ++++++++ +++++++
+     + +                               + +     +
+     + +                               + +     +
+     + +                               + +     +
+     + +                               + +     +
+     + +                               + +     +
+     + +                               + +     +
+     + +                               + +     +
+     + +                               + +     +
+     + +                               + +     +
+     + +                               + +     +
+     + +                               + +     +
+++++++ +++++++                  ++++++++ +++++++
+             +                  + Z 8+    W    +
+             +                  + Z  +   WW    +
+WWWWW    WWWW+                  + X  Z         +
+   GGG    W  +                  ++++++    WWWWW+
+   FFF    W  +                  +         W    +
+   EEE    W  +                  +WWWWW    W    +
+XXXCCCE      ++++++++++++++++++++  W     W  XXX+
+CBADCCE                W           W     W ABE +
+XXXCCCE      ++++++++++++++++++++           XXX+
+   EEE    W  +                  +   X+ DDD     +
+   FFF    W  +                  +  X + DDD     +
+   GGG    W  +                  + X  + +D+     +
+      WWWWWWW+                  +X   + +5+     +
+             +                  +    + +3+     +
+++++++++++++++                  ++++++++++++++++
+++++++++++++++++++++++++++++++++++++++++++++++++
#goal
+++++++++++++++++++++++++++++++++++++++++++++++++
+    + +      +                  +      + +     +
+    + +      +                  +      + +     +
+    + +      +                  +      + +     +
+    + +      +                  +      + +     +
++++++ ++++++++                  ++++++++ +++++++
+7   +        +                  +        +    9+
+    +        +                  +        +     +
+             +                  +             W+
+             +                  +              +
+  Z          +                  +              +
+             +                  +              +
+             ++++++++++++++++++++              +
+                  A        B                   +
+             ++++++++++++++++++++              +
+             +                  +              +
+             +                  +              +
+          4  +                  +              +
+             +                  +              +
+             +                  +              +
+++++++ +++++++                  ++++++++ +++++++
+     + +                               + +     +
+     + +                               + +     +
+     + +                               + +     +
+     + +                               + +     +
+     + +                               + +     +
+     + +                               +6+     +
+     + +                               + +     +
+     + +                               + +     +
+     + +                               + +     +
+     + +                               + +     +
+     + +                               + +     +
+++++++ +++++++                  ++++++++ +++++++
+             +                  +8   +         +
+             +                  +    +         +
+             +                  +X             +
+             +                  ++++++         +
+             +                  +              +
+             +                  +              +
+             ++++++++++++++++++++              +
+                                               +
+             ++++++++++++++++++++              +
+             +                  +    +         +
+             +                  +    +         +
+             +                  +    + + +     +
+             +                  +    + + +     +
+             +                  +    + + +     +
+++++++++++++++                  ++++++++++++++++
+++++++++++++++++++++++++++++++++++++++++++++++++
#end
