#domain
hospital
#levelname
brAIn
#colors
blue: 0, B
green: 1, R
red: 2, A, I
purple: 3, N
#initial
+++++++++++++++++++
+B+ + + + + + + +R+
+ + + + + +   + + +
+   + +   + + +   +
+ + + + + + + + + +
+ + +   + + +   + +
+ +   + + + + + + +
+ + + + +   + + + +
+ + +0+1+ +2+3+ + +
+ + + +   + + + + +
+ + + + + + + + + +
+ +   + +   +   + +
+ + + + + + + + + +
+   + + + + + +   +
+ + +   + +   + + +
+N+ + + + + + +I+A+
+++++++++++++++++++
#goal
+++++++++++++++++++
+ + + + + + + + + +
+ + + + + +   + + +
+   + +   + + +   +
+ + + + + + + + + +
+ + +   + + +   + +
+ +   + + + + + + +
+ + + + +   + + + +
+ + +B+R+A+I+N+ + +
+ + + +   + + + + +
+ + + + + + + + + +
+ +   + +   +   + +
+ + + + + + + + + +
+   + + + + + +   +
+ + +   + +   + + +
+ + + + + + + + + +
+++++++++++++++++++
#end
