#domain
hospital
#levelname
Cliff
#colors
purple: 0, M, N 
red: 1, A, O
#initial
                   +++++++++
                   +       +
++++++++++++++++++++       +
+      +     +     +       +
+ 1    +     +     +       +
+      +     +   0 +       +
+      +     +     +       +
+                  +       +
+++++++++O+ +++++++++  +++ +
+        N+             +  +
+        M+             +  +
+        A              +  +
+                       +  +
+         +             +  +
+         +             +  +
+         +             + ++
+++++++++++++++++++++++++++
#goal
                   +++++++++
                   +       +
++++++++++++++++++++       +
+      +     +     +       +
+      +     +     +       +
+      +     +     +       +
+      +     +     +       +
+                  +       +
+++++++++ + +++++++++  +++ +
+         +             +  +
+         +             +  +
+                       +  +
+                       +  +
+         +             +O +
+         +             +NM+
+         +             +A++
+++++++++++++++++++++++++++
#end
