#domain
hospital
#levelname
CompCheck
#colors
blue: 0, A
green: 1, B
red: 2, C
cyan: 3, D
#initial
+++++++++++++++++++++++++++
+                        0+
+ +++++++++++++ ++++++++1 +
+ +++++++++++++ +++++++++++
+              A          +
+ +++++++++++++++++++++++++
+       B                 +
+ +++++++++++++++++++++++++
+ +++++++++++++++++++++++++
+      C                  +
+ +++++++++++++++++++++++++
+  D                      +
+ + +++++++++++++++++++++++
+ + ++++++++++++++++++++2 +
+                        3+
+++++++++++++++++++++++++++
#goal
+++++++++++++++++++++++++++
+                         +
+ +++++++++++++ ++++++++AB+
+ +++++++++++++ +++++++++++
+                        0+
+ +++++++++++++++++++++++++
+                        1+
+ +++++++++++++++++++++++++
+ +++++++++++++++++++++++++
+                        2+
+ +++++++++++++++++++++++++
+                        3+
+ + +++++++++++++++++++++++
+ + ++++++++++++++++++++CD+
+                         +
+++++++++++++++++++++++++++
#end