#domain
hospital
#levelname
Eighty
#colors
blue: 0,A,4,8,E
red: 1,B,5,9
green: 2,C,6
grey: 3,D,7
#initial
+++++++++++++++++++++++++++++++++++++++++++++
+                     +                     +
+                     +                     +
+C0                                       2A+
+                     +                     +
+B3                                       1D+
+                     +                     +
+                     +                     +
+++++++++++++++++++++++++++++++++++++++++++++
+++++++++++++++++++++++++++++++++++++++++++++
+4                +   +   +                 +
+                 +   +   +                A+
+5                +   +   +                B+
+                 + + + + +                 +
+6                + + + + +                C+
+                 + + + + +                D+
+7                  +   +                   +
+++++++++++++++++++++++++++++++++++++++++++++
+++++++++++++++++++++++++++++++++++++++++++++
+                     +                     +
+                    8+                     +
+                 +++++++++                A+
+                 E                         +
+                 +++++++++                B+
+                    9+                     +
+                     +                     +
+++++++++++++++++++++++++++++++++++++++++++++
#goal
+++++++++++++++++++++++++++++++++++++++++++++
+                     +                     +
+                     +                     +
+D2                                       0B+
+                     +                     +
+A1                                       3C+
+                     +                     +
+                     +                     +
+++++++++++++++++++++++++++++++++++++++++++++
+++++++++++++++++++++++++++++++++++++++++++++
+          ABCD   +   +   +                4+
+                 +   +   +                 +
+                 +   +   +                5+
+                 + + + + +                 +
+                 + + + + +                6+
+                 + + + + +                 +
+                   +   +                  7+
+++++++++++++++++++++++++++++++++++++++++++++
+++++++++++++++++++++++++++++++++++++++++++++
+                     +                     +
+                    9+                     +
+A                +++++++++                 +
+                                           +
+B                +++++++++                 +
+                    8+                     +
+                     +                     +
+++++++++++++++++++++++++++++++++++++++++++++
#end