#domain
hospital
#levelname
EulerPpl
#colors
blue: 0, A, 1, 2, 3, B
cyan: 4, C, D, E, 5
green: 6, I
pink: 7, G, H
red: 8, 9, L
#initial
++++++++++++++++++++++++++++++++++++++++++++++++
+      +       +  +                            +
+0AA   +     A +1 + 4C                 III    5+                
+      +       ++++                  ++ 8I  L  +
+   +  +          +         +++++++++6 +++++++++
++++ +++       ++ +  9      +7G               H+
+3    B+2       + +     D   +++++++++ ++++++++++
++++++++++++++++++++++++++++++++++++++++++++++++
#goal
++++++++++++++++++++++++++++++++++++++++++++++++
+      +       +  +                            +
+      +       +  +         D                  +
+      +       ++++ 5                ++       L+
+   +  +          +         +++++++++6 +++++++++
++++ +++       ++ +  9      +H                G+
+B     +        +A+    C    +++++++++ ++++++++++
++++++++++++++++++++++++++++++++++++++++++++++++
#end
