#domain
hospital
#levelname
FastCipka
#colors
purple: 0, A, B
blue: 1, C, D, F
#initial
++++++++++++++++++++++++++++
+ C                        +
+D1F                       +
+                          +
+                          +
+                          +
+++ ++++++++++++++++++++++ +
+         +             +  +
+         +             +  +
+                       +  +
+                       +  +
+         +            0+A +
+         +             +  +
+B        +             +  +
++++++++++++++++++++++++++++
#goal
++++++++++++++++++++++++++++
+                       CD +
+B                         + 
+                         F+
+                          +
+                          +
+++ ++++++++++++++++++++++ + 
+         +             +  +
+         +             +  +
+                       +  +
+                       +  +
+         +             +  +
+         +             +  +
+         +            A+  +
++++++++++++++++++++++++++++
#end
