#domain
hospital
#levelname
JarvisExe
#colors
brown: 0,M,E
pink: 1,D,S
#initial
+++++++++++++++
+            0+
+ +++++  E  + +
+ +   +     + +
+ + M +++++++ +
+     +       +
+ +++++       +
+             +
+             +
+ +++++++++++ +
+  +       D+ +
+  +    +++++ +
+       +     +
+   +++++ S + +
+       +   + +
+1      +++++ +
+++++++++++++++
#goal
+++++++++++++++
+            0+
+ +++++     + +
+ +   +     + +
+ +   +++++++ +
+     +       +
+ +++++       +
+       MEDS  +
+             +
+ +++++++++++ +
+  +        + +
+  +    +++++ +
+       +     +
+   +++++   + +
+       +   + +
+1      +++++ +
+++++++++++++++
#end