#domain
hospital
#levelname
MABRY
#colors
blue: 0, A, E
red: 1, D, G
cyan: 2, C
green: 3, B, F
#initial
+++++++++++
++++ ++ +++
++++ G+ +++
++++D + +++
+++++E+  ++
+  1     ++
+         +
+  ++++  A+
+++++++ 0++
++F  B   ++
++C++    3+
++ ++2+   +
+++++++++++
#goal
+++++++++++
++++D++E+++
++++  + +++
++++  + +++
+++++ +  ++
+        ++
+        G+
+ C++++   +
+++++++  ++
++       ++
++ ++ A  F+
++ ++ +B  +
+++++++++++
#end
