#domain
hospital
#levelname
MAIzeRun
#colors
red: 0, A
green: 1, B
blue: 2, C
orange: 3, D
#initial
++++++++++++++++
+0+   +        +
+ +   + +      +
+ + 2 + +      +
+ + + + +      +
+ + + + +      +
+ + + + +      +
+ + + + + +++D +
+ + + + +      +
+ + + + + C+++ +
+ + + + +      +
+ + + + + +++B +
+ 1 + 3 +      +
+   +   + A+++ +
+   +   +      +
++++++++++++++++
#goal
++++++++++++++++
+A+   +        +
+ +   + +      +
+ + C + +      +
+ + + + +      +
+ + + + +      +
+ + + + +      +
+ + + + + +++  +
+ + + + +      +
+ + + + +  +++ +
+ + + + +      +
+ + + + + +++  +
+ B + D +      +
+   +   +  +++ +
+   +   +      +
++++++++++++++++
#end