#domain
hospital
#levelname
minotaur
#colors
blue: 0, A, B
red: 1, C
cyan: 2, E
pink: 3, D
green: 4, F
#initial
+++++++++++
+++++++ + +
+ 0  A+ + +
+ 4   +   +
+++++ + +++
+         +
++B       +
+++++++   +
++       ++
++  F1+   +
+++++++ + +
+C      +++
+       +++
++D++    ++
+ 2 +  3E +
+++++++++ +
+++++++++++
#goal
+++++++++++
+++++++A+E+
+     + + +
+     +   +
+++++ + +++
+         +
++       B+
+++++++  C+
++       ++
++    +  F+
+++++++ + +
+       +++
+       +++
++ ++    ++
+   +     +
+++++++++D+
+++++++++++
#end