#domain
hospital
#levelname
mishmash
#colors
blue: 0, 1, A, I
green: 2, 3, 5, B
brown: 4, 6
cyan: 7, D, E, M, S, H
#initial
++++++++++++++++++++++++++++
++++++++++MISHMASH++++++++++
++++++++++++++++++++++++++++
+A   A++1A B2++34   ++D  E +
+     ++++ ++++++ ++++D D E+
+     ++++ ++++5   6++ D E +
+A   0++     ++     ++D   7+
++++++++++++++++++++++++++++
#goal
++++++++++++++++++++++++++++
++++++++++        ++++++++++
++++++++++++++++++++++++++++
+     ++     ++6   5++ D D +
+     ++++ ++++++ ++++     +
+     ++++ ++++4   3++     +
+    A++B   A++     ++    D+
++++++++++++++++++++++++++++
#end