#domain
hospital
#levelname
Naevis
#colors
blue: 0, 1, 2, 3, A
#initial
++++++++++++++++++++++++++++++++
+0             +              1+
+              +               +
+              A               +
+              A               +
+              +               +
+              +               +
+++++++AA++++++++++++++AA+++++++
+              +               +
+              +               +
+              A               +
+              A               +
+              +               +
+3             +              2+
++++++++++++++++++++++++++++++++
#goal
++++++++++++++++++++++++++++++++
+0             +              1+
+              +               +
+                              +
+                              +
+              +               +
+            AA+AA             +
+++++++  ++++++++++++++  +++++++
+              +               +
+              +               +
+                              +
+                              +
+              +               +
+3           AA+AA            2+
++++++++++++++++++++++++++++++++
#end
