#domain
hospital
#levelname
NHL
#colors
blue: 0, A
red: 1, B
green: 2, C
brown: 3, D
lightblue: 4, E
pink: 5, F
cyan: 6, G
#initial
++++++++++++++++++++
+  0    1   2    3 +
+ ++++ ++++++ ++++ +
+    +     B+ +    +
+ ++ + ++++ + + ++ +
+    +   E+ + +D   +
+ ++++ ++++ +C++++ +
+  4               +
+ ++++ +    +++ ++ +
+  A + +           +
+ ++ + +     ++++  +
+    +   +      +  +
+ ++++ ++++ +++++  +
+              G+  +
+ ++++ ++++++ + +  +
+    +        + +  +
+ ++ + ++++ + + +  +
+ 5F +      +   +6 +
++++++++++++++++++++
#goal
++++++++++++++++++++
+                  +
+ ++++ ++++++ ++++ +
+    +      + +G   +
+ ++F+ ++++ + + ++ +
+    +    + + +    +
+ ++++ ++++ + ++++ +
+                  +
+ ++++ +    +++ ++ +
+    + +           +
+ ++ + +     ++++  +
+    +  B+     E+  +
+ ++++ ++++ +++++  +
+               +  +
+ ++++ ++++++ + +  +
+   A+        + +  +
+ ++ + ++++ + + +  +
+    +     C+   + D+
++++++++++++++++++++
#end