#domain
hospital
#levelname
NoOp
#colors
blue: 0, 1, 2, 9, A
green: 3, 4, 5, B
cyan: 6, D
purple: 7, E
orange: 8, F
pink: G
grey: C, Y
lightblue: N, O, P
#initial
+++++++++++++++++++++++++
+9+           C +A   G  +
+ +B+++       C + 1     +
+ +   +  +  + C +       +
+ +   +       C +    G  +
+ +  A+3+    +C +A      +
+ +   +  ++++ C +       +
+     +         +       +
+++++++++++++++++    G  +
+      7                +
+   +   +  + +  + +     +
+   + + +  +++   +   D  +
+    + +   + +   +      +
+  G  D                 +
+   + +   6        +++  +
+  + + +  +++  + + + E  +
+  +   +  +Y+  + + ++   +
+  +   +  +++   +  + E  +
+         N0OP     +++  +
+    D    FFFF          +
+           8           +
+++++++++++++++++++++++++
+   2 +    BA5          +
+  B 4+     A     B     +
+++++++++++++++++++++++++
#goal
+++++++++++++++++++++++++
+ +            A+       +
+ + +++         +       +
+ +   +  +  +   +       +
+ +   +         +       +
+ +   + +    +  +       +
+ +   +  ++++   +       +
+     +         +       +
+++++++++++++++++       +
+                       +
+   +   +  + +  + +     +
+   + + +  +++   +      +
+    + +   + +   +      +
+                       +
+   + +            +++  +
+  + + +  +++  + + +    +
+  +   +  +Y+  + + ++   +
+  +   +  +++   +  +    +
+                  +++  +
+                       +
+                       +
+++++++++++++++++++++++++
+     +           B     +
+     +                 +
+++++++++++++++++++++++++
#end
