#domain
hospital
#levelname
PandorAI
#colors
green:0,D,O,N,K
orange:1,E,Y
red:2,T,M,I
#initial
+++++++++++++++++++++++++++++++++++++++++++++++++
+              +++  ++++++++                    +
+            +++    +++++++++          Y        +
+                   ++++++++++ +++              +
+          +       ++++++++++++   +             +
+         +       +++++++++++++++  +            +
+         +       ++++++++++++ ++  +            +
+        +        ++++++++++++ ++  +            +
+  +    +          +++++++++++  +  +            +
+  ++  +     0        ++++  +     +             +
+  + ++        ++      ++         +             +
+  +  +  + + +++  +            ++++++           +
+  +       ++++++  +    +     ++++++            +
+  + ++    +        ++       ++++++++  E   1    +
+   ++++   ++       +++   ++ +++++++++          +
+    +++    +        ++    ++++++++++++         +
+    ++++   ++++++++ +      ++++++++++++        +
+    ++++   +++      +   T  +++++++++++++       +
+   +       ++ ++++         +++++++++++++++++   +
+    +++++  +++++++  +      +++++++++++++++  +  +
+    +++++  +++++++ +       ++++++++++++++++    +
+    + +++ ++++++  +       +++++++++++++++++++  +
+    + + +++++++++         +++++++++++++++++++  +
+    +  +++++++++   I     ++++++++++++++++++++  +
+ K  +     ++             ++++++++++++++++++++  +
+   ++      +   ++        ++++++++++++++++++++  +
+  + +        ++++        ++++++++++++++++++++  +
+  + +       +++++      ++++++++++++++++++++++  +
+  + +       ++++      +++++++++++++++++++++++  +
+  +  +   + ++++         +++++++++++++++++++++  +
+  +  +     +++     M +  +++++++++++++++++++++  +
+  +   ++              +  +++  +++++++++++++++  +
+  +    +       N       +      +++++++++++++++  +
+  +    +                +     ++++++++++++++   +
+  +     +          +++   +    ++++++++++++++   +
+  +      ++++++               +++++++++++++    +
+  +      +                      ++++++++++     +
+  +       +             +       +++++++++      +
+  +       +        O    +      ++++++++++      +
+  +       +            +      ++++++++++       +
+   +       +       ++++      ++++++++++        +
+   +        +               +++++++            +
+   +        ++             +++++++  ++       2 +
+    +   E    + +           +++++++  +          +
+    +         + +        ++++++++   +          +
+    +          + ++   +++++++++   ++     D     +
+    +          +                               +
+               +  +                            +
+++++++++++++++++++++++++++++++++++++++++++++++++
#goal
+++++++++++++++++++++++++++++++++++++++++++++++++
+              +++  ++++++++                    +
+            +++    +++++++++                   +
+                   ++++++++++ +++              +
+          +       ++++++++++++   +             +
+         +       +++++++++++++++  +            +
+         +       ++++++++++++ ++  +            +
+        +        ++++++++++++ ++  +            +
+  +    +          +++++++++++  +  +            +
+  ++  +              ++++  +     +             +
+  + ++        ++      ++         +             +
+  +  +  + + +++  +            ++++++           +
+  +       ++++++  +    +     ++++++            +
+  + ++    +        ++       ++++++++           +
+   ++++   ++       +++   ++ +++++++++          +
+    +++    +        ++    ++++++++++++         +
+    ++++   ++++++++ +      ++++++++++++        +
+    ++++   +++      +      +++++++++++++       +
+   +       ++ ++++         +++++++++++++++++   +
+    +++++  +++++++  +      +++++++++++++++  +  +
+    +++++  +++++++ +       ++++++++++++++++    +
+    + +++ ++++++  +       +++++++++++++++++++  +
+    + + +++++++++         +++++++++++++++++++  +
+    +  +++++++++         ++++++++++++++++++++  +
+    +     ++             ++++++++++++++++++++  +
+   ++      +   ++        ++++++++++++++++++++  +
+  + +        ++++        ++++++++++++++++++++  +
+  + +       +++++      ++++++++++++++++++++++  +
+  + +       ++++      +++++++++++++++++++++++  +
+  +  +   + ++++         +++++++++++++++++++++  +
+  +  +     +++       +  +++++++++++++++++++++  +
+  +   ++              +  +++  +++++++++++++++  +
+  +    +               +      +++++++++++++++  +
+  +    +                +     ++++++++++++++   +
+  +     +          +++   +    ++++++++++++++   +
+  +      ++++++               +++++++++++++    +
+  +      +                      ++++++++++     +
+  +       +             +       +++++++++      +
+  +       +             +      ++++++++++      +
+  +       +            +      ++++++++++       +
+   +       +       ++++      ++++++++++        +
+   +        +               +++++++            +
+   +        ++             +++++++  ++         +
+    +        + +           +++++++  +          +
+    +         + +        ++++++++   +          +
+    +          + ++   +++++++++   ++           +
+    +          +        DONKEY TIME            +
+               +  +                            +
+++++++++++++++++++++++++++++++++++++++++++++++++
#end