#domain
hospital
#levelname
Raffaello
#colors
blue: 0, A
red: 1, B
green: 2
#initial
+++++++++++++++++++
++2              ++
+0 +        B  +  +
+                 +
+1+++++++++++++++A+
+                 +
+++++++++++++++++++
#goal
+++++++++++++++++++
++             1B++
+  +           +  +
+                 +
+ +++++++++++++++ +
+2               A+
+++++++++++++++++++
#end
