#domain
hospital
#levelname
sadbois
#colors
blue: 0, S
green: 1, A
red: 2, D
#initial
+++++++++++
+0       1+
+ +++ +++ +
+ +S   A+ +
+ +     + +
+         +
+ +     + +
+ +D    + +
+ +++ +++ +
+    2    +
+++++++++++
#goal
+++++++++++
+    2    +
+ +++ +++ +
+ +    D+ +
+ +     + +
+         +
+ +     + +
+ +A   S+ +
+ +++ +++ +
+0       1+
+++++++++++
#end