#domain
hospital
#levelname
SALTY
#colors
blue: 0, S
green: 1, A
red: 2, L
cyan:4, T
purple: 3, Y
#initial
++++++++++++++++++++
+  0    1   2    3 +
+ ++++ ++++++ ++++ +
+    +     S+ +    +
+ ++ + ++++ + + ++ +
+    +   T+ + +L   +
+ ++++ ++++ + ++++ +
+         4        +
+ ++++ +        ++ +
+  A + +           +
+ ++ + +     ++++  +
+    +   +      +  +
+ ++++ ++++ +++++  +
+              Y+  +
+ ++++ ++++++ + +  +
+    +        + +  +
+ ++ + ++++ + + +  +
+    +      +   +  +
++++++++++++++++++++
#goal
++++++++++++++++++++
+                  +
+ ++++ ++++++ ++++ +
+    +      + +    +
+ ++ + ++++ + + ++ +
+    +    + + +    +
+ ++++ ++++ + ++++ +
+                  +
+ ++++ +   SALTY++ +
+    + +           +
+ ++ + +     ++++  +
+    +   +      +  +
+ ++++ ++++ +++++  +
+               +  +
+ ++++ ++++++ + +  +
+    +        + +  +
+ ++ + ++++ + + +  +
+    +      +   +  +
++++++++++++++++++++
#end