#domain
hospital
#levelname
Spiraling
#colors
Blue: 0,A
Red: 1,B
Cyan: 2,C
Purple: 3,D
Green: 4,E
Orange: 5,F
Pink: 6,G
Lightblue: 7,H
Brown: 8,I
Grey: 9,J,R,O,U,P,T,W,N,Y
#initial
++++++++++++++++++++++++++++
+++++++++++GROUP++++++++++++
+++++++++++TWENTY+++++++++++
++++++++++++++++++++++++++++
+++++++++++++9++++++++++++++
+++++++++++++             ++
+++++++++++++++++++++++++ ++
+++++++++++++5+++++++++++ ++
++                     ++ ++
++ +++++++++++++++++++ ++ ++
++ ++++++++++1++++++++ ++ ++
++ ++               ++ ++ ++
++ ++ +++++++++++++ ++ ++ ++
++ ++ +         J + ++ ++ ++
++ ++ +        I  + ++ ++ ++
++ ++ +       H   + ++ ++ ++
++ ++ +      G    + ++ ++ ++
+6 +2 +     F     + 0+ 4+ 8+
++ ++ +    E      + ++ ++ ++
++ ++ +   D       + ++ ++ ++
++ ++ +  C        + ++ ++ ++
++ ++ + B         + ++ ++ ++
++ ++ +A            ++ ++ ++
++ ++ ++++++++++++++++ ++ ++
++ ++                  ++ ++
++ ++++++++++3+++++++++++ ++
++ ++++++++++++++++++++++ ++
++                        ++
+++++++++++++7++++++++++++++
++++++++++++++++++++++++++++
#goal
++++++++++++++++++++++++++++
+++++++++++GROUP++++++++++++
+++++++++++TWENTY+++++++++++
++++++++++++++++++++++++++++
+++++++++++++J++++++++++++++
+++++++++++++             ++
+++++++++++++++++++++++++ ++
+++++++++++++F+++++++++++ ++
++                     ++ ++
++ +++++++++++++++++++ ++ ++
++ ++++++++++B++++++++ ++ ++
++ ++               ++ ++ ++
++ ++ +++++++++++++ ++ ++ ++
++ ++ +           + ++ ++ ++
++ ++ +           + ++ ++ ++
++ ++ +           + ++ ++ ++
++ ++ +           + ++ ++ ++
+G +C +           + A+ E+ I+
++ ++ +           + ++ ++ ++
++ ++ +           + ++ ++ ++
++ ++ +           + ++ ++ ++
++ ++ +           + ++ ++ ++
++ ++ +             ++ ++ ++
++ ++ ++++++++++++++++ ++ ++
++ ++                  ++ ++
++ ++++++++++D+++++++++++ ++
++ ++++++++++++++++++++++ ++
++                        ++
+++++++++++++H++++++++++++++
++++++++++++++++++++++++++++
#end
