#domain
hospital
#levelname
StarGrid
#colors
blue: 0, G
brown: 1, A, B
red: 2, H
cyan: 3, I
purple: 4, J
green: 5, C, D
#initial
++++++++++++++++++++++++++++++++++++++++++++++
++++++++++++++++++++++++++++++++++++++++++++++
++++++++++++++++++++++ 0++++++++++++++++++++++
+++++++++++++++++++++    +++++++++++++++++++++
++++++++++++++++++++  ++  ++++++++++++++++++++
+++++++++++++++++++ H++++  +++++++++++++++++++
++++++++++++++++++  ++++++  ++++++++++++++++++
+++++++++++++++++  ++++++++  +++++++++++++++++
+1               2   AB      5             D +
++  +++++++++++   +++++++++   +++++++++++   ++
+++   ++++++++ G +++++++++++   ++++++++ C ++++
+++++   +++++   +++++++++++++   ++++    ++++++
+++++++   +    +++++++++++++++   +    ++++++++
+++++++++       ++++++++++++    J  +++++++++++
+++++++++   +++    ++++++    +++  ++++++++++++
++++++++  ++++++++ I       ++++++  +++++++++++
+++++++  +++++++   +++++   +++++++  ++++++++++
++++++  ++++++   +++++++++   ++++++  +++++++++
+++++  +++++   +++++++++++++   +++++  ++++++++
++++  ++++   +++++++++++++++++   ++++  +++++++
+++++   4  +++++++++++++++++++++    3 ++++++++
++++++++++++++++++++++++++++++++++++++++++++++
#goal
++++++++++++++++++++++++++++++++++++++++++++++
++++++++++++++++++++++++++++++++++++++++++++++
++++++++++++++++++++++ G++++++++++++++++++++++
+++++++++++++++++++++    +++++++++++++++++++++
++++++++++++++++++++  ++  ++++++++++++++++++++
+++++++++++++++++++  ++++  +++++++++++++++++++
++++++++++++++++++ H++++++  ++++++++++++++++++
+++++++++++++++++  ++++++++  +++++++++++++++++
+AB                  CD                      +
++  +++++++++++   +++++++++   +++++++++++   ++
+++   ++++++++   +++++++++++   ++++++++   ++++
+++++   +++++   +++++++++++++   ++++    ++++++
+++++++   +    +++++++++++++++   +    ++++++++
+++++++++       ++++++++++++       +++++++++++
+++++++++   +++    ++++++    +++  ++++++++++++
++++++++  ++++++++         ++++++  +++++++++++
+++++++  +++++++   +++++   +++++++  ++++++++++
++++++  ++++++   +++++++++   ++++++  +++++++++
+++++  +++++   +++++++++++++   +++++  ++++++++
++++  ++++   +++++++++++++++++   ++++  +++++++
+++++ J    +++++++++++++++++++++    I ++++++++
++++++++++++++++++++++++++++++++++++++++++++++
#end