#domain
hospital
#levelname
TreOTres
#colors
blue: 0, A
red: 1, B
#initial
+++++++++++++
+0    ++   A+
+   +  +    +
+ ++++++++  +
+   1+      +
+        B  +
+++++++++++++
#goal
+++++++++++++
+     ++  A +
+   + 0+    +
+ ++++++++  +
+   1+      +
+  B        +
+++++++++++++
#end