#domain
hospital
#levelname
Tryhard
#colors
red: 0, A
blue: 1, B
cyan: 2, C, T
green: 3,4,5
orange: 6, 7, G, P
#initial
++++++++++++++
+C   1       +
+  ++  ++++  +
+  ++ 2++++  +
+  ++  ++++  +
+  ++  ++++  +
+  ++  ++++  +
+  ++  ++++  +
+  ++  ++++  +
+0  AB       +
+            +
++++++++++++++
#goal
++++++++++++++
+10          +
+  ++  ++++  +
+  ++  ++++  +
+  ++  ++++  +
+  ++  ++++  +
+  ++  ++++  +
+  ++  ++++  +
+  ++  ++++  +
+       A B C+
+            +
++++++++++++++
#end
