#domain
hospital
#levelname
URAStar
#colors
red: 2, A, B, C, D
green: 3, E, F, G, H
purple: 0, I
brown: 1, J
pink: 4, X, Z
#initial
+++++++++++++++++
+++             +
+++ ++++++++ ++ +
+0IJ         ++ +
+++1+++++++++++ +
+ +   + +   + + +
+ +   + +   + +Z+
+ +   + +   + +4+
+ +   + +   + +X+
+ +   + +   + + +
+ +   + +   + + +
+      23     + +
+   ABCDEFGH    +
+++++++++++++++++
#goal
+++++++++++++++++
+++            Z+
+++ ++++++++ ++ +
+          JI++ +
+++ +++++++++++ +
+D+   +4+   +H+ +
+C+   + +   +G+ +
+B+   + +   +F+ +
+A+   + +   +E+ +
+2+   + +   +3+ +
+ +   + +   + + +
+             + +
+              X+
+++++++++++++++++
#end
