#domain
hospital
#levelname
UrBlocked
#colors
red: 0, A
green: 1, B
purple: 2, K, L, M
blue: 3, G, H, J
orange: 4
grey: 5, C, D, E, F
#initial
+++++++++++++++++++++++++++++++++++
+ 0   AB        ++                +
+               ++                +
+   F           ++         ++++++ +
+  E1C                          + +
+   D           ++              + +
+               ++              + +
+      +++   +++++              +++
+               ++                +
+               ++                +
+      HJ+      +++++++           +
+++++  G5+      ++    +           +
++++   +++  ++++++    +           +
+++++           ++                +
++++                              +
+++++           ++                +
+4 K            +++++ 2++         +
+3 L    +       +++++++++  ++++++++
+++M    +       +++               +
+++++++++++++++++++++++++++++++++++
#goal
+++++++++++++++++++++++++++++++++++
+               ++                +
+               ++                +
+               ++         ++++++1+
+                               + +
+               ++         4    + +
+               ++              +A+
+      +++   +++++              +++
+       5       ++             F  +
+               ++             D  +
+        +      +++++++        2  +
+++++    +      ++   G+           +
++++H  +++  ++++++    +        C  +
+++++           ++             E  +
++++J                             +
+++++           ++                +
+               +++++  ++         +
+       +       +++++++++  ++++++++
+++     +     3 +++          B   0+
+++++++++++++++++++++++++++++++++++
#end
