#domain
hospital
#levelname
WhatAGrid
#colors
blue: 0, G, K
brown: 1, A, B
red: 2, H
cyan: 3, I
purple: 4, J
green: 5, C, D
orange: 6, E, F
#initial
++++++++++++++++++
++++ +++ +++ +++++
++++ +++ +++ +++++
++++1+++5+++6+++++
+0             G +
++++ +++ +++ +++++
+2             H +
++++ +++ +++ +++++
+3             I +
++++ +++ +++ +++++
+4             J +
++++A+++C+++E+++++
++++B+++D+++F+++++
++++++++++++++++++
#goal
++++++++++++++++++
++++A+++C+++E+++++
++++B+++D+++F+++++
++++ +++ +++ +++++
+G               +
++++ +++ +++ +++++
+H               +
++++ +++ +++ +++++
+I               +
++++ +++ +++ +++++
+J               +
++++ +++ +++ +++++
++++ +++ +++ +++++
++++++++++++++++++
#end
