#domain
hospital
#levelname
YSERIOUS
#colors
blue: 0, A
red:  B, C
green: 1, D
#initial
+++++++++++++++++++++++++++++++++++++++++++++++++
+                                               +
+                                               +
+                                               +
+                                               +
+                                               +
+                                               +
+                                               +
+                                               +
+            +++++             +++++            +
+           +     +           +     +           +
+          AD     +           +     AD          +
+           +     +           +     +           +
+          AD     +           +     AD          +
+           +     +           +     +           +
+            +++++             +++++            +
+                                               +
+                                               +
+              0                 1              +
+                                               +
+    C                                      C   +
+   C+CC                                  CC+C  +
+   C+++CC                              CC+++C  +
+   C+  ++CCC                        CCC++  +C  +
+    C+   +++CCCC                CCCC+++   +C   +
+     C+     ++++CCCCC      CCCCC++++     +C    +
+      C+        +++++CCCCCC+++++        +C     +
+       C++           ++++++           ++C      +
+        CC++                        ++C        +
+          CC++++                ++++CC         +
+            CCCC++++++++++++++++CCCC           +
+                CCCCCCCCCCCCCCCC               +
+                                               +
+                                               +
+                                               +
+                                               +
+                                               +
+                                               +
+                                               +
+                                               +
+                                               +
+                                               +
+                                               +
+                                               +
+                                               +
+                                               +
+                                               +
+                                               +
+                                               +
+++++++++++++++++++++++++++++++++++++++++++++++++
#goal
+++++++++++++++++++++++++++++++++++++++++++++++++
+                                               +
+                                               +
+                                               +
+                                               +
+                                               +
+                                               +
+            AAAA               DDDD            +
+                                               +
+            +++++             +++++            +
+           +     +           +     +           +
+                 +           +                 +
+           +     +           +     +           +
+                 +           +                 +
+           +     +           +     +           +
+            +++++             +++++            +
+                                               +
+                                               +
+              0                                +
+                                               +
+                                               +
+    +                                      +   +
+    +++                                  +++   +
+    +  ++                              ++  +   +
+     +   +++                        +++   +    +
+      +     ++++                ++++     +     +
+       +        +++++      +++++        +      +
+        ++           ++++++           ++       +
+          ++                        ++         +
+            ++++                ++++           +
+                ++++++++++++++++               +
+                                               +
+                                               +
+                                               +
+                                               +
+                                               +
+                                               +
+                                               +
+                                               +
+                                               +
+                                               +
+                                               +
+                                               +
+                                               +
+                                               +
+                                               +
+                                               +
+                                               +
+                                               +
+++++++++++++++++++++++++++++++++++++++++++++++++
#end