#domain
hospital
#levelname
YummAI
#colors
blue: 0, A
red: 1, B
green: 2, C
brown: 3, D
lightblue: 4, E
pink: 5, F
cyan: 6, G
#initial
                                                  
 ++++++++++++++++++++++++++++++++++++++++++++++++ 
 +++++++++++++++++++++++++++++0++++++++++++++++++ 
 +++++++++++++++++++++++++++A+A++++++++++++++++++ 
 ++++++++++++++++++++++++ A    ++++++++++++++++++ 
 +++++++++++++++++++++++  A++  ++++++++++++++++++ 
 ++++++++++++++++++++++A  +++++++++++++++++++++++ 
 +++++++++   E  4++++++  ++++++++++++++++++++++++ 
 +++++++E    +  E+++++  +++++++++++++++++++++++++ 
 +++++++     +    +++   ++++++++++++++++++B++++++ 
 +++++++  ++++   +++   +++++++++++++++++++A++++++
 +++++++  +++   +++   ++++++++++++++++++++B++++++ 
 +++++   +++    +   C+++++++++  ++++++++++A++++++ 
 +++     ++      + C2++++++      +++++++++C++++++ 
 ++   +++++                      +++++++++A++++++ 
  +  +++                          +++++++++++++++ 
 +   ++                      ++++++++++++++++++++ 
 +++++++                   ++++++++++++++++++++++ 
 +++1 BB                   ++++++++++++++++++++++ 
 +++  BB               F+++++++++++++++++++++++++ 
 +++           +++5    ++++++++++++++++++++++++++ 
 +++++  +++  +++++++   F+++++++++++++++++++++++++ 
 +++++  +++  +++++++   F+++++++++++++++++++++++++ 
 +++++  +++  +++++++3   +++++++++++++++++++++++++ 
 +++++  +++  +++++++    +++++++++++++++++++++++++ 
 +++++ +++++ ++++++D D+  ++++++++++++++++++++++++ 
 +++++ B++++  ++++++ D++ ++++++++++++++++++++++++ 
 ++++++++++++++++++++++++++++++++++++++++++++++++ 
                                                  
#goal
                                                  
 ++++++++++++++++++++++++++++++++++++++++++++++++ 
 +++++++++++++++++++++++++++++A++++++++++++++++++ 
 +++++++++++++++++++++++++++A+ ++++++++++++++++++ 
 ++++++++++++++++++++++++0  A A++++++++++++++++++ 
 +++++++++++++++++++++++   ++  ++++++++++++++++++ 
 ++++++++++++++++++++++  A+++++++++++++++++++++++ 
 +++++++++4  E  E++++++  ++++++++++++++++++++++++
 +++++++     +   +++++  +++++++++++++++++++++++++ 
 +++++++    E+    +++   ++++++++++++++++++ ++++++ 
 +++++++  ++++   +++   +++++++++++++++++++ ++++++ 
 +++++++  +++   +++   ++++++++++++++++++++ ++++++ 
 +++++   +++    +D   +++++++++  ++++++++++ ++++++ 
 +++     ++      +   ++++++      +++++++++ ++++++ 
 ++   +++++                      +++++++++ ++++++ 
  +  +++                          +++++++++++++++ 
 +   ++                      ++++++++++++++++++++ 
 +++++++                  F++++++++++++++++++++++ 
 +++BB                   5F++++++++++++++++++++++ 
 +++1B                  +++++++++++++++++++++++++ 
 +++BB         +++     ++++++++++++++++++++++++++ 
 +++++  +++  +++++++    +++++++++++++++++++++++++ 
 +++++  +++  +++++++    +++++++++++++++++++++++++ 
 +++++  +++  +++++++    +++++++++++++++++++++++++ 
 +++++  +++C +++++++    +++++++++++++++++++++++++ 
 +++++ +++++ ++++++   +D3++++++++++++++++++++++++ 
 +++++  ++++2C++++++  ++D++++++++++++++++++++++++ 
 ++++++++++++++++++++++++++++++++++++++++++++++++ 
                                                  
#end